k k k k k k k k k k k k k g k k k k k k k k k k k k k k k k k k
k k k k k k k k k k k k k g k k k k k k k k k k k k k k k k k k
k k k k k k k k k k k k k g k k k k k k k k k k k k k k k k k k
k k k k k k k k k k k k k g k k k k k k k k k k k k k k k k k k
k k k k k k k k k k k k k g k k k k k k k k k k k k k k k k k k
k k k k k k k k k k k k k g k k k k k k k k k k k k k k k k k k
k k k k k k k k k k k k k g k k k k k k k k k k k k k k k k k k
k k k k g g g g g g g g g g g g g g g g g g g k k k k k k k k k
k k k k g k k k k k k k k k k k k k k k k k g k k k k k k k k k
k k k k g k k k k k k k k k k k k k k k k k g k k k k k k k k k
k k k k g k k k k k k k k k k k k k k k k k g k k k k k k k k k
k k k k g k k k k k k k k k k k k k k k k k g k k k k k k k k k
k k k k g k k k k k k k k k k k k k k k k k g k k k k k k k k k
k k k k g k k k k k k k k k k k k k k k k k g k k k k k k k k k
k k k k g k k k k k k k k k k k k k k k k k g k k k k k k k k k
k k k k g k k k k k k k k k k k k k k k k k g k k k k k k k k k
k k k k g k k k k k k k k g g g k k k k k k g k k k k k k k k k
g g g g g k k k k k k k k g k g k k k k k k g g g g g g g g g g
k k k k g k k k k k k k k g g g k k k k k k g k k k k k k k k k
k k k k g k k k k k k k k k k k k k k k k k g k k k k k k k k k
k k k k g k k k k k k k k k k k k k k k k k g k k k k k k k k k
k k k k g k k k k k k k k k k k k k k k k k g k k k k k k k k k
k k k k g k k k k k k k k k k k k k k k k k g k k k k k k k k k
k k k k g k k k k k k k k k k k k k k k k k g k k k k k k k k k
k k k k g k k k k k k k k k k k k k k k k k g k k k k k k k k k
k k k k g g g g g g g g g g g g g g g g g g g k k k k k k k k k
k k k k k k k k k k k k k g k k k k k k k k k k k k k k k k k k
k k k k k k k k k k k k k g k k k k k k k k k k k k k k k k k k
k k k k k k k k k k k k k g k k k k k k k k k k k k k k k k k k
k k k k k k k k k k k k k g k k k k k k k k k k k k k k k k k k
k k k k k k k k k k k k k g k k k k k k k k k k k k k k k k k k
k k k k k k k k k k k k k g k k k k k k k k k k k k k k k k k k