o o o o o o o o o o o o o o o o o o o o o o o o o o o o o o o o
o o o o o o o o o o o o o o o o o o o o o o o o o o o o o o o o
o o o o o o o k o o o o o o o o o o o o o o o o o o o o o o o o
o o o g o o o k o o o o o o o o o o o o o o o o o o o o o o o o
o o o g o o o k o o o o o o o o o o o o o o o o o o o o o o o o
o o o g o o o k o o o o o o o o o o o o o o o o o o o o o o o o
o o o o o o o k o o o o o o o o o o o o o o o o o o o o o o o o
o o o o o o o k o o o o o o o o o o o o o o o o o o o o o o o o
o o o o o o o o o o o o o o o o o o o o o o o o o o o o o o o o
o o o o o o o o o o o o o o o o o o o o o o o o o o o o o o o o
o o o o o o o o o o o o o o o o o o o o o o o o o o o o o o o o
o o o o o o o o o o o o o o o o o o o o o o o o o o o o o o o o
o o o s s s s s s s s s s s s s s o k o s s s s s s s s o o o o
o o o s o o o o o o s o o o o o o o o o o o o o o o o s o o o o
o o o s o o o o o o s o o o o o o o o o e o e o e o o s o o o o
o o o s o k o s o o s o o o o o o o o o o o o o o g o s o o o o
o o o s o k o s o o s o o o o o o o o o e o e o e o o s o o o o
o o o s o g o s o o s s s o o o o o o o o o o o o g o s o o o o
o o o s o o o s o o o o o o o o o o o o e o e o e o o s o o o o
o o o s s s s s o o o o o o o o o o o o o o o o o o o s o o o o
o o o o o o o s o o o o o o o o o o o o o o o o o o o s o o o o
o o o o o o o s s s s s s s o k o s s  s s s s s s s s s o o o o
o o o o o o o o o o o o o o o o o o o o o o o o o o o o o o o o
o o o o o o o o o o o o o o o o o o o o o o o o o o o o o o o o
o o o o o o o o o o o o o o o o o o o o o o o o o o o o o o o o
o o o o o o k o o o o o o o o o o o o o o o o o o o o o o o o o
o o o o o o o o o o o o o o k o g o k o o o o o o o o o o o o o
o o o o g o o o o o o o o o t e e e t o o o o o o o g o o o o o
o o o o o o o o o o o o o o o o o o o o o o o o o o o o o o o o
o o o o o o k o o o o o o o o o o o o o o o o o o o o o o o o o
o o o o o o o o o o o o o o o o o o o o o o o o o o o o o o o o
o o o o o o o o o o o o o o o o o o o o o o o o o o o o o o o o